10 11
0 0
00 00 00 00 13 00 00 00 00 00
02 02 02 02 13 02 02 02 02 02
09 12 05 17 04 12 10 09 05 17
08 12 03 12 09 10 08 11 13 01
01 01 08 05 11 08 12 12 03 10
16 12 05 06 01 09 12 05 11 13
01 09 03 04 12 06 01 13 01 13
16 11 08 10 09 04 05 03 12 06
01 01 14 07 06 14 08 06 01 13
01 09 04 06 07 03 12 06 09 06
01 08 12 04 11 08 12 11 08 11