10 11
0 0
00 00 00 00 00 00 00 00 00 00
02 02 02 02 18 02 02 02 02 02
09 12 05 12 04 12 10 09 05 16
08 12 03 16 09 10 08 11 13 01
01 01 08 05 11 08 12 12 03 10
17 12 05 06 01 09 12 05 11 13
01 09 03 04 12 06 01 13 01 13
17 11 08 10 09 04 05 03 12 06
01 01 15 07 06 15 08 06 01 13
01 09 04 06 07 03 12 06 09 06
01 08 12 04 11 08 12 11 08 11